
	n = 20

+--+--+--+--+--+--+--+--+--+--+--+--+--+--+--+--+--+--+--+--+
   |        |     |  |        |        |  |  |  |           |
+  +--+  +--+  +--+  +  +--+  +--+  +--+  +  +  +--+  +--+--+
|        |  |        |  |        |              |        |  |
+--+--+  +  +  +--+--+--+--+  +--+--+  +--+--+  +--+  +--+  +
|  |  |        |  |                 |     |     |        |  |
+  +  +--+  +--+  +  +  +--+--+--+  +--+  +--+--+  +--+--+  +
|  |     |     |  |  |     |              |           |  |  |
+  +--+  +--+  +  +  +  +--+  +--+--+--+  +--+--+--+  +  +  +
|                    |  |  |           |     |              |
+  +--+  +--+--+--+  +--+  +  +  +  +--+  +--+  +  +--+  +--+
|     |  |        |  |     |  |  |  |     |  |  |     |     |
+  +--+  +--+--+  +--+--+  +--+--+  +--+--+  +  +  +--+  +  +
|     |  |        |           |        |  |     |     |  |  |
+  +--+  +--+--+  +--+--+--+  +--+--+  +  +--+  +--+  +--+--+
|  |  |  |  |              |     |  |  |        |           |
+  +  +--+  +--+--+  +--+  +  +--+  +--+  +  +--+--+  +--+--+
|  |           |  |  |     |     |     |  |  |              |
+  +  +  +--+  +  +--+--+  +  +--+--+  +  +  +--+--+  +  +  +
|     |  |        |        |  |        |  |     |     |  |  |
+--+  +--+--+  +--+--+--+  +  +--+  +--+--+--+--+--+--+  +--+
|     |  |  |  |  |  |  |     |              |              |
+  +  +  +  +--+  +  +  +  +--+--+--+--+  +  +  +--+--+  +  +
|  |     |     |  |           |     |     |  |     |  |  |  |
+  +--+--+--+  +  +--+  +  +--+--+  +  +  +  +--+  +  +--+  +
|           |           |  |        |  |  |  |        |  |  |
+--+--+  +--+  +--+--+--+  +--+  +--+--+  +  +--+  +--+  +  +
|        |     |  |        |           |  |     |        |  |
+--+  +  +  +  +  +  +  +--+--+  +--+--+  +  +--+  +--+  +--+
|     |     |  |     |     |              |     |     |  |  |
+--+--+  +--+  +--+  +--+  +  +--+--+  +--+--+--+--+  +--+  +
|     |  |     |        |  |     |  |     |     |           |
+  +  +  +  +--+  +--+  +  +  +--+  +  +  +--+  +--+  +--+--+
|  |  |  |  |  |  |     |           |  |           |  |  |  |
+--+  +  +--+  +  +  +--+  +--+--+--+--+--+  +--+--+  +  +  +
|              |  |     |        |  |        |           |  |
+--+--+--+  +--+--+  +--+--+  +--+  +  +--+  +  +--+--+  +  +
|  |           |     |           |  |  |  |           |  |  |
+  +  +  +--+  +  +--+--+--+--+--+  +  +  +--+--+  +--+  +  +
|     |  |     |     |                 |              |      
+--+--+--+--+--+--+--+--+--+--+--+--+--+--+--+--+--+--+--+--+